SampleId	TotalReads	SMN1_C_count	SMN1_Total_count	SMN2_C_count	SMN2_Total_count	SMN c.840:C	SMN c.840:total
MAAC002	109329415	0	48	0	30	0	78
MAAC003	87015899	0	31	0	14	0	45
MAAC005	103720447	0	17	0	31	0	48
MAAC008	77600234	0	32	0	40	0	72
MAAC017	131209457	0	83	0	22	0	105
MAAC057	123287062	0	1	0	78	0	79
MANT033	109030241	0	1	0	211	0	212
MCAI001	97995461	0	0	0	170	0	170
MNOT001	81566763	0	0	0	189	0	189
MPAU019	109458569	0	0	0	92	0	92
