SampleId	TotalReads	SMN1_C_count	SMN1_Total_count	SMN2_C_count	SMN2_Total_count	SMN c.840:C	SMN c.840:total
MAAC002	109329415	48	48	0	30	48	78
MAAC003	87015899	31	31	0	15	31	46
MAAC005	103720447	17	17	0	31	17	48
MAAC008	77600234	32	32	0	39	32	71
MAAC017	131209457	82	83	0	22	82	105
MAAC057	123287062	0	1	0	76	0	77
MANT033	109030241	0	1	0	213	0	214
MCAI001	97995461	0	0	0	174	0	174
MNOT001	81566763	0	0	0	189	0	189
MPAU019	109458569	0	0	0	94	0	94
